00000000000000000000000000000000000000000000000000000000000000000000000000000000000000000000000000000000000000000000000000000000000000000000000000000000000000000000000000000000000000000000000000000000
00000000000000000000000000000000000000000000000000000000000000000000000000000000000000000000000000000000000000000000000000000000000000000000000000000000000000000000000000000000000000000000000000000000
00000000000000000000000000000000000000000000000000000000000000000000000000000000000000000000000000000000000000000000000000000000000000000000000000000000000000000000000010000000000000000000000000001000
00000000000000000000000000000000000000000333000000000000000000000000000000001111100000000000000000000000000000033333000000000000000000000000000000000000000000000000000000000000000000000000000000000000
00000000000000000000000003300000000002200000000002200000000000000000000110000000000000000000000000000000000000000000000000000010000000000000001100001000100001000101000100101001000100000000000000001000
00000000000000000000000000000000330000000000000000000000004444000444400000000000000022002222001002200020003300000100000100000000000000001100100000100000000000000000000000000000000000022220000100000000
00000000000002220000333000000000000000000000000000000000000000000000000000000000000000000000000000000000000000000000000000000000010100000000000000000000000000000000000000000000000000000000010000000000
11111111110000000000000000000000000000000000000044444400000000000000000000000000000000000000000000022220000000000000000000011110000000000000000000000000000000000000000000000000000000000000000001111000